{
  "name": "small_open",
  "resource_amount": 500,
  "grid": [
    "##################",
    "#1...R...........#",
    "#................#",
    "#.....###........#",
    "#R...............#",
    "#................#",
    "#.......R........#",
    "#........R.......#",
    "#................#",
    "#...............R#",
    "#........###.....#",
    "#................#",
    "#...........R...2#",
    "##################"
  ]
}
