{
  "name": "twin_peaks",
  "resource_amount": 500,
  "grid": [
    "##############################",
    "#1...........................#",
    "#...R........................#",
    "#..........R..##.............#",
    "#.........#...##.............#",
    "#.R......##..................#",
    "#........##...........###....#",
    "#........##..................#",
    "#.........#..R...............#",
    "#......R.....................#",
    "#.....................R......#",
    "#...............R..#.........#",
    "#..................##........#",
    "#....###...........##........#",
    "#..................##......R.#",
    "#.............##...#.........#",
    "#.............##..R..........#",
    "#........................R...#",
    "#...........................2#",
    "##############################"
  ]
}
